1111111
10M11C1
1P011M1
10M0101
11M00M1
11110E1
1111111
