1111111111111111111
1CE11000000001100C1
1001111100011110101
1000100000000000001
100M0010011M0010001
1000000000000000101
100010000C000110101
1000110000000010101
1000011111000110001
1010000011000110001
100011111100M110001
10C0100000000000101
100010000110C000101
1001100P010000101M1
1111111111111111111
