1111111111111111
10M11C10000000E1
1001100000000001
10M0100000000001
11M00M0000000001
11110E0000000001
1110000000011111
1100000000001111
1110011100000011
100011C000000011
1P00110000001111
1111111111111111
