1111111111
1P00C011E1
1001111001
10010000C1
1000000111
10010001C1
1001111101
1011010001
1000000001
1111111111
