1111111
1001101
1P01101
1000101
1100001
1111001
1111111
