1111111
10011C1
1P01101
1000101
1100001
11110E1
1111111
