111111111
1T00000C1
10P001101
101001001
1010T1E11
111111111
