1111111111
1000C011E1
1001111001
10010000C1
1000P00111
10010001C1
1001111101
1011010001
1000000001
1111111111
