1111111111
1P000C11E1
1001111C01
1001000001
1000000111
10C10001C1
1001111101
1011010001
1000C00001
1111111111
