1111111111
1P000011E1
1001111C01
1001000001
1000000111
10010001C1
1001111101
1011010001
10CCCC0001
1111111111
