1111111111
1P000011E1
1001111001
1001000001
1000000111
10C10001C1
1001111101
1011010001
1000CCC001
1111111111
