111111111111111
1CE110000000011
100111110001111
1000100C0000001
100000100110001
100000000110001
100010000000011
100011000000001
100001111100011
101000001100011
10C011111100011
101010000000001
100010000111001
1001100P010C001
111111111111111
