111111111111111111111111111111111111111111111
100000000000000001111111000000000000001111101
100011111000011000000001011111100011000111001
100000001111000111000001000000110001100010001
100111100101010001111111100000011100000000011
100010000000010000001001111100010000001011011
101011111111011100000001000100000011100011011
1010001110M000001111000M000011100000000000001
100010011011100000111100000000000111110100101
10110000110001110000011110000110001000M100111
100111000000000000110000011001100010001100001
110111101101010111011111001011100111100101011
100011111000011000000000011011100011000101001
100000001111000111000001000000110001100010001
1001111M0101010001111111100000011100000000011
100010000000010000001001111100010000001011011
101011111111011100000001000100000011100011011
101000111000000011110000000011100000000000001
10001M011011100000111100000M00000111110100101
101100001100011100000111100001100010000100111
1001110000000000001100000110011000100111P0CE1
111111111111111111111111111111111111111111111
